1111111111111111
1C000000P1C01111
1011100000101001
1C00000000C010C1
1111100C00101011
1E000000001110C1
11000C0000000011
1C00000000111111
11111100000000C1
1000000011111101
1C11111000000101
1010000011110011
1010C100000000C1
1C11110111111111
1010C000000000C1
1111111111111111