111111111
1C00P1C11
11110101
1C0000C01
111110101
1E000111
111111111
