1111111111111
100C000000001
1010001111101
1P0001E000001
1111111111111