111111111
1C00P1C01
101110001
1C0000C01
111110101
100000111
111111111
