111111111
1C00P1C01
101110001
1C0000C01
111110101
1E1000111
111111111
