111111111
1C00P1C11
101110101
1C0000C01
111110101
1E0000111
111111111
